1111111111111111
1000000000000001
1000001000000001
1P00001000000001
1000001011111001
1000111110000001
1000100011000001
1000100001000001
1100000001000001
1000C00001000001
1000C00111000001
10C00000E1000001
1111111111111111